1111  1111  1111
11            11
11 B        B 11
11 11  11  11 11
11 B        B 11
11 11  11  11 11
11      B     11
11  1  11   1 11
11            11
11   11 1  11 11
11            11
11    11  11  11
11            11
1111111111111111

