1111111111111111
11 1 1   1 11 11
11 1 1   1 11 11
11 1 1   1 11 11
1111111111111111
11            11
11 P P  P P P 11
11            11
11            11
111 11 11 11 111
11            11
11111      11111
11            11
1111111111111111
