1111111111111111
11            11
11            11
11F F F F F F 11
111 1 1 1 1 1 11
11            11
111 1 1 1 1  111
11            11
1111 1  1 1 1111
11            11
11 1 1  1 1 1111
11            11
11            11
1111111111111111
