1111  11   1111
11           11
11           11
11 1 1 1 1 1 11
11           11
11 1 1 1 1 1 11
11  B1B1B1B  11
11 111111111 11
11  111111   11
111 111111  111
11  1 11 1   11
111 1 11 1  111
11  1    1   11
111 111111 1111