1111   11  1111
11           11
11        R  11
11     11111111
11           11
11 1         11
11111111     11
11           11
11     1  R  11
11    111111111
11           11
11           11
11 111 111 1 11
11           11
1111  11  11111

