11111 1111 11111
11 F    F   F 11
1111   111  1111
11 F    F   F 11
1111   111  1111
11      F     11
1111  1111  1111
11            11
1111  1111  1111
11            11
111    11    111
11            11
11            11
1111111111111111
