1111111111111111
1   P      P   1
1   H      H   1
1              1
1              1
1              1
1              1
1              1
1              1
1              1
1              1
1              1
1              1
1111111111111111