11111 1111 11111
11            11
11            11
11 1 1 1 1 1 111
11 1M1  S  1M111 
11 111 111 11111
11            11
11 P        P 11
11            11
11 1 1   1 1  11
11 1M1   1M1  11
11 111   111  11
11            11
11111 1111 11111
