11111  11 11111
11    RRR    11
11 B 11111 B 11
11 B 11 11 B 11
11 111111111 11
11  11 1 11  11
11  1    1   11
11           11
11           11
11 11 111 11 11
11           11
11    11     11
11    11     11
11111 11 111111


