1111111111111111
11            11
11            11
11            11  
1111111111111111
11            11
11 S S P S S S11
11            11
11            11
11            11
11            11
11            11
11            11
1111111111111111

