11111  1  11111
11           11
11           11
11 1      1  11
11 1 1  1 1  11
11 111  111  11
11 1 R  R 1  11
11 111  111  11
11 1      1  11
11 11111111  11
11           11
1111 1 11  1111
11           11
111111111111111

