1111   11   1111
11            11
11            11
11 1 1 11 1 1 11
11            11
11 1 1 11 1 1 11
11  B1B11B1B  11
11 1111111111 11
11  1111111   11
111 1111111  111
11  1 111 1   11
111 1 111 1  111
11  1     1   11
1111 111111 1111