11111 1111 11111
11            11
11            11
11  11111111  11
11 1 11  1 11 11
11 1 11  1 11 11
11 1P11P11P11 11
11 1 11  1 11 11
11 1 11  1 11 11 
11  11111111  11
11            11
11  11    11  11
11            11
11111 1111 11111
