11111  11  11111
11            11
11  1      1  11
11 11  11  11 11
11  1  11  1  11
11B 1      1 B11
11  1      1  11
11B 11    11 B11
11  111  111  11
11B 1 1  1 1 B11
111 1     1  111
11  111 111   11
11            11
11111  11  11111
