1111111111111111
11            11
11            11
11            11  
1111111111111111
11            11
11 F F F F F F11
11            11
11            11
11            11
11            11
11            11
11            11
1111111111111111

