11111 1111 11111
11     P      11
1111 P   P  1111
111          111
11 P11    11 P11
11   11  11   11
11   11  11   11
11   11  11   11
11  11    11  11
11 11      11 11
11 1111  1111 11
11            11
11            11
11111 1111 11111
