1111  111  1111
11           11
11  1   R 1  11
11  1 11111  11
11           11
11  1  R  1  11
11  1111111  11
11           11
11  1  R  1  11
11  1 11111  11
11   R   R   11
11  111 111  11
11           11
1111  111  1111

