11111 1111 11111
11 H   H    H 11
1111   111  1111
11 H    H   H 11
1111   111  1111
11      H     11
1111  1111  1111
11            11
1111  1111  1111
11            11
111    11    111
11            11
11            11
1111111111111111