1111  11  11111
11   R    R  11
11  111 111  11
11  1     1  11
11  1 R R 1  11
11  111 111  11
11  1     1  11
11  1     1  11
11  111 111  11
11           11
11           11
1111 11 11 1111
11           11
11111  1  11111

