11111 1111 11111
1    H    H    1
11   1    1   11
1              1
11    S       11
1              1
11   1    1   11
1              1
11            11
1    Z    Z    1
11   1    1   11
1              1
11            11
11111 1111 11111