1111   11  11111
11            11
111 1 1  1 1 111
11 R        R 11
11111 11   11111
11 1 R 111 R  11     
11  11    11  11 
1 1 11  111 1  1
11 R  11   R  11
11 11 1111 11 11 
11            11
1111 1 11 1 1111
11            11
11111  111  1111
