111111111111111
11    R R    11
11   11111   11
11           11
11   R   R   11
11   11 11   11
11           11
11           11
11   11111   11
11           11
11           11
11  1  1  1  11
11           11
111111111111111


