11111 1111 11111
11            11
11 111  111   11
11 1 1  1 1 1 11
11            11
11            11
11            11
11          1 11
11 1      111 11
11 1      11  11         
11 1BBBBB111  11
11  1111111   11
11            11
1111111111111111
