1111111111111111
11            11
11   R R R    11
111  111111  111
11            11
11            11
111  111111  111
11            11
11            11
111  111111  111
11            11
11            11
1111111111111111
1111111111111111
