1111111111111111
11            11
11   I    I   11
111  111111  111
11            11
11    I  I    11
111  111111  111
11            11
11            11
111  111111  111
11            11
11            11
1111111111111111
1111111111111111
