11111 11111 1111
11    1   1   11
111          111
111   1 F 1  111
1111  1 F 1 1111
111   1 F 1  111
1111  1 F 1 1111
111   1 F 1  111
1111  1 F 1 1111
11    1   1   11
11  11    11  11
111          111
11            11
1111111111111111
