11111 1111 11111
11            11
11            11
11 1 1 11 1 1 11
11            11
11 1 1 11 1 1 11
11            11
11B P B P B P 11
11 1 1 1 1 1  11
11            11
11            11
11 1 1 1 1 1  11
11            11
11111 1111 11111