11111 11111 1111
11    1   1   11
111          111
111   1 H 1  111
1111  1 H 1 1111
111   1 H 1  111
1111  1 H 1 1111
111   1 P 1  111
1111  1 P 1 1111
11    1   1   11
11  11    11  11
111          111
11            11
1111111111111111
