111111111111111
11           11
11   R R R   11
111  11111  111
11           11
11           11
111  11111  111
11           11
11           11
111  11111  111
11           11
11           11
111111111111111
111111111111111
