11111  11  11111
111          111
111          111
1111  1111  1111
111  1    1  111
11 1  1  1  1 11
11  111   111 11
11  1  111  1 11
11 F  1111  F 11
11  11111111  11
11 B B B  B B 11
11  11111111  11
11            11
11111 111  11111
