1111  111  11111
11 R        R 11
11 1        1 11
11111     111111
11B          B11
11 1        1 11
11111     111111
11            11
11Z          Z11
11111     111111
11            11
11  111  111  11
11            11
1111  111   1111

