1111  111  1111
11           11
11  1      1 11
11  11  1 11 11
11 1       1 11
11 11 111 11 11
11      1    11
11  1  11  1 11
11           11
11   11 1 11 11
11           11
11    11 11  11
11           11
111111111111111

