11111 111 11111
11           11
11 1 R R R R 11
11 111 11111111
11 111 11111 11      
11 111 111   11
11 11  11111111   
111 1    1  111
11 1 F R F 1 11
111 1 111 1 111
11           11
11  111 111  11
11           11
11111111  11111
