1111   11  1111
11 1       1 11
11   F   F   11
11 1111 1111 11
11  P     P  11
11     P     11
11           11
11 111111111 11
11           11
1111 11  111111
11           11
111111111 11111
11           11
1111    11  1111
