111111111111111
11 B 1   1 B 11
11 111   111 11
11 1  B B  1 11
11 1  11   1 11
11   1   1   11
11 B  111 B  11
111    B    111
111 1    1  111
111 1    1  111
111  1111   111
11    11     11
11   11111   11
111111111111111
